#######################################
***************************************
***************************************
***************************************
***************************************
***************************************
***************************************
***************************************
***************************************
***************************************
***************************************
***************************************
***************************************
***************************************
************############***************
***************************************
***************************************
***************************************
***************************************
***************************************
***************************************
***************************************
***************************************
***************************************
***************************************
***************************************
***************************************
***************************************
***************************************
#######################################