#######################################
***************************************
***************************************
***************************************
***************************************
***************************************
***##########************##########****
***************************************
***************************************
***************************************
***************************************
***************************************
***************************************
***************************************
************############***************
***************************************
***************************************
***************************************
***************************************
***************************************
***************************************
***************************************
***************************************
***##########*************##########***
***************************************
***************************************
***************************************
***************************************
***************************************
#######################################